"   ----------------------------------------------------------------------------------------",
"      -                 -     -  -  -  -  -     -           -  -        -  -     -     -  -",
"----  -  ----  -  ----  -  -  -  -  -  -  ----  -  ----  -  -  -------  -  ----  ----  -  -",
"-     -  -  -  -  -  -     -  -        -              -  -     -              -     -  -  -",
"-  -------  -------  ----  ----  ----------------  -------  ----------  -  -------  -  -  -",
"-              -  -  -        -        -                 -  -        -  -     -           -",
"-  ----  ----  -  -  -  -  ----  -  -------  -  -------  ----------  -  -  -------------  -",
"-  -  -     -  -     -  -        -        -  -  -  -     -     -  -     -     -        -  -",
"-  -  -  ----------  ----  ----  ----  ----  ----  ----  ----  -  -  -  -------  -------  -",
"-     -     -           -  -  -  -     -        -     -              -  -     -        -  -",
"-  ----  -  ----  -  -  -  -  -  -  -  ----  -  -  ----------  -  -  -  -  ----  -  ----  -",
"-  -     -     -  -  -     -     -  -     -  -  -              -  -  -  -     -  -        -",
"-  ----  ----  -------  ----------  ----------  -  -  -  ----  -------------  ----  -  -  -",
"-  -  -  -  -  -  -           -           -  -  -  -  -  -           -  -  -        -  -  -",
"-  -  ----  -  -  ----  -  ----  -------  -  ----------  -  ----  ----  -  ----  -  -------",
"-           -     -     -  -  -     -  -     -  -        -  -           -     -  -        -",
"----  ----  -------------  -  -  ----  -  -  -  ----  -  -------  ----  ----  -  ----  -  -",
"-  -  -  -  -                 -  -  -     -  -        -  -  -  -     -  -     -  -     -  -",
"-  -  -  -------  ----------------  -  -------  -------  -  -  ----  -  -  ----------  -  -",
"-     -  -           -  -        -        -        -     -        -  -  -     -        -  -",
"-  -  -  ----  -  -  -  -  -  ----  ----  -  ----  -  -  ----  -------  -  -  -------  ----",
"-  -           -  -     -  -  -     -        -     -  -     -     -  -     -     -  -     -",
"-  -  -  ----  -  -  ----  ----------  -  ----  -  ----  ----  -  -  -  -------  -  ----  -",
"-  -  -     -  -  -           -        -     -  -  -  -  -     -  -     -     -  -        -",
"----  -------  ----  -------  ----------  -  -------  -  ----  -  -  -------  -  -  -  ----",
"-           -  -  -  -        -     -     -  -  -     -  -  -  -     -        -     -     -",
"-  ----  ----  -  -  ----------  -------  ----  ----  ----  -  -------  ----  -  ----------",
"-  -     -  -     -  -  -           -     -              -     -  -  -     -           -  -",
"----  -  -  -------  -  -  ----------------------------  ----  -  -  ----  -  ----  -  -  -",
"-     -  -                 -              -              -        -  -     -  -     -     -",
"-  ----  -  ----  -------------------  ----  -------  ----  ----  -  -  ----  ----  ----  -",
"-     -  -     -     -           -        -  -           -  -        -  -        -  -     -",
"-  ----  ----  -------  ----  ----  ----  ----  -------  -------  -  ----  ----  -------  -",
"-     -  -        -        -  -     -        -  -  -           -  -  -  -  -        -     -",
"-  -------------  ----  -------  -------------  -  ----  -  -  ----  -  -  ----  ----  -  -",
"-     -  -           -  -           -  -     -     -     -  -  -     -     -        -  -  -",
"----  -  ----------  -  ----------  -  -  -------------  ----------------  ----  ----  ----",
"-  -        -     -  -  -                       -        -     -           -     -        -",
"-  ----  -  ----  -  -  -------  ----------  ----------  -  -------------------  ----  -  -",
"-        -  -  -     -  -     -  -  -  -  -     -              -           -        -  -  -",
"----------  -  ----  -  ----  -  -  -  -  -  ----------  -  ----  -  ----------  -------  -",
"-           -           -              -        -        -  -     -           -     -     -",
"----  -  ----  ----  ----------  -  -------------  -------  ----  -  -  ----  ----  ----  -",
"-  -  -     -     -  -  -  -     -        -  -  -  -  -  -        -  -  -  -  -        -  -",
"-  -------  ----------  -  ----------  -  -  -  ----  -  -  -  -------  -  -  -  ----------",
"-           -     -     -     -     -  -     -        -     -        -     -        -     -",
"-------------  ----  ----  -  ----  -------  ----  ----------------------  -  ----  ----  -",
"-           -  -  -        -  -  -  -  -     -  -  -     -  -     -     -  -     -        -",
"-  ----  -  -  -  -  ----------  -  -  -  ----  -  -  ----  -  ----  -  -  -------  -  ----",
"-     -  -        -  -     -  -           -  -  -           -        -  -  -     -  -  -  -",
"----  ----  ----  -  -  ----  -------  ----  -  -  -  -  -  -  ----  -------  ----  ----  -",
"-        -  -  -        -  -  -     -           -  -  -  -        -        -              -",
"----  -  -  -  ----------  -  ----  -  ----  -  -------  -------------  -  ----  -------  -",
"-     -  -  -              -  -     -     -  -  -  -  -        -  -     -        -  -     -",
"----------  -  ----  -  ----  -  -------  -  ----  -  ----------  -  -------------  ----  -",
"-           -     -  -  -                 -              -     -     -  -  -     -  -  -  -",
"-  ----------------  -  ----------  ----  -  ----  ----  -  ----  -  -  -  -  ----  -  ----",
"-     -     -  -     -        -  -  -     -  -        -  -     -  -     -  -           -  -",
"-  -------  -  ----  ----  ----  -  ----  ----------  -  -  -------  -  -  ----  -------  -",
"-                    -              -        -        -              -                    ",
"----------------------------------------------------------------------------------------  "
